0000000000
0111111110
0100000010
010S000010
01000B0010
0100000010
010000T010
0100000010
0111111110
0000000000