00111110
11100010
1TSB0010
1110BT10
1T11B010
1010T011
1B0XBBT1
1000T001
11111111