type octile
height 50
width 12
map
.@..........
.@..........
.@@.........
..@.........
..@.........
..@@........
...@........
...@........
...@@.......
....@.......
....@.......
....@@......
.....@......
.....@......
.....@......
.....@......
.....@......
.....@......
.....@......
.....@......
.....@......
.....@......
.....@......
.....@......
.....@......
.....@......
.....@......
.....@......
.....@......
.....@......
.....@......
.....@......
.....@......
.....@......
.....@......
.....@......
.....@......
.....@......
.....@......
.....@......
.....@......
.....@......
.....@@.....
......@.....
......@.....
......@.....
......@.....
......@.....
......@.....
............